
 NO  ./north 

SO ./south

    WE   ./west
EA    ./east
  F   220,100,255, // 쉼표 갯수 체크하면댐


C 225,30,0




                                  
                                
                       
                  

                                           
                                                1
  1111111 1111 111 111   111111111  
  1     1 11111111111111111111111
  1     1100000000110000000000001
  1111111111111111111111111111111 
        1011000001110000000000001
        1001000000000000000000001
111111111011000001110000000000001
100000000011000001110111111111111
11110111111111011100000010001
   1110000000 000011100000111
11110111111111011101010010001
11000000110101011100000010001         11111111
10000000000000001100000010001        100001   
10000000000000001101010010001         1111111
11000001110101011111011110N0111
11110111 1110101 101111010001
11111111 1111111 111111111111
                                     
                                        
                     
                                         
                                    
 
