
 NO  ./north

SO ./south

  F     0,255,255
    WE                 ./west
C 225,30,0
EA    ./east



     111                         
111111
1N1 1
111111
      
             
             