    WE   ./texture/west  
 NO ./texture/north


EA    ./texture/east
F     220,100,0
SO ./texture/south
C 225,30,0

1111
1N11
1111
