    WE   ./west 
 NO ./north


EA    ./east
F     220,100,0
SO ./south
C 225,30,0

  1111111 1111 111 111   1111111
  1    1 11111111111111111111111
  1    1100000000110000000000001
  1111111111111111111111111111111 
        1011000001110000000000001
        1001000000000000000000001
111111111011000001110000000000001
100000000011000001110111111111111
11110111111111011100000010001
   11100000000000000000000111
11110111111111011101010010001
11000000110101011100000010001     
10000000000000001100000010001    
1000000000000001101010010001     111
110000011010101111101111000111    101
11110111 1110101 101111010001     11
11111111 1111111 111111111111
                
               
     
     